****************
*XX*XX*XX*XX*XX*
*XX*XX*XX*XX*XX*
****XX**********
*XX*XX*XXXXX*XX*
*XX*XX*XXXXX*XX*
*XX*************
*XX*XX*XX*XXXXX*
*XX*XX*XX*XXXXX*
****************
